XXXXXXXXXXXXX
X00000000000X
X00000000000X
X00000000000X
X00011100000X
X00011100000X
X00000000000X
X00000000000X
X00000000000X
XXXXXXXXXXXXX